{
    "uint 1": {
        "101": 4,
        "102": 8,
        "103": 6,
        "104": 4,
        "105": 4,
        "106": 4,
        "107": 2,
        "108": 2,
        "109": 6,
        "110": 4
    },
    "uint 2": {
        "201": 6,
        "202": 6,
        "203": 6,
        "204": 4,
        "205": 4,
        "206": 6,
        "207": 4,
        "208": 4,
        "209": 4,
        "210": 2
    },
    "uint 3": {
        "301": 6,
        "302": 6,
        "303": 6,
        "304": 4,
        "305": 4,
        "306": 4,
        "307": 4,
        "308": 4,
        "309": 6,
        "310": 6,
        "311": 2,
        "312": 6
    },
    "uint 4": {
        "401": 6,
        "402": 6,
        "403": 6,
        "404": 4,
        "405": 4,
        "406": 6,
        "407": 4,
        "408": 4,
        "409": 4,
        "410": 2,
        "411": 6
    }
}
